9
27
*s*************************
*               *         *
* ***** ******* * ******* *
*          *    * *     * *
**** * ***** **** * * * * *
*    *     * *    * * * * *
* **** *** *** **** *** * *
*                    *  * *
***********************g***